111111111
101111111
101001111
100101111
111110011
101101011
110001011
101111101
111111111